111111111111111
1E00000000000C1
101110111000001
1P000101C000001
111111111111111
