1111111111111
1E100000000C1
1110010111001
1P000101C0001
1111111111111