1111111111111
10010000000C1
100001111111
1P0011E00011
1111111111